NO ./img/greystone.xpm
SO ./img/purplestone.xpm
WE ./img/redbrick.xpm
EA ./img/wood.xpm

C  204,204,255
F  250,231,110

     111111111111111111111111111111
    111N000000000000000000000000011
11111110000000000000000000000001111
100000000000000000000001111011111
1000000000000000111000011110011
100000000000000000000001111001
111111111111111111111111111111
