NO ./img/bluestone.xpm
SO ./img/colorstone.xpm
WE ./img/redbrick.xpm
EA ./img/greystone.xpm

F 100,60,100
C 50,0,110

      111111111111111111
      111110000011111111
111111111000000011
100000000000000001
1000000S0010000001
100000000000000001
100011111111110001
100000000000000001
100000011100000001
111111111111111111